.............................
.............................
/////////////////////////////
/.........................../
/.........................../
/.........................../
/.........................../
/.........................../
/.........................../
/.........................../
/.........................../
/.........................../
/.............@............./
/.........................../
/.........................../
/.........................../
/.........................../
/.........................../
/.........................../
/.........................../
/.........................../
/.........................../
/.........................../
/.........................../
/.........................../
/.........................../
/.........................../
/.........................../
/.........................../
/.........................../
/.........................../
/.........................../
/.........................../
/.........................../
/.........................../
/.........................../
/.........................../
/////////////////////////////