

///////////////////
/......../......../
/e//.///././//.//e/
/................./
/.//././////././/./
/..../.../.../..../
////./// / ///.////
////./       /.////
////./ ///// /.////
P....  /   /  ....P
////./ ///// /.////
////./       /.////
////./ ///// /.////
/......../......../
/.//.///././//.//./
/e./.....@...../.e/
//./././////./././/
/..../.../.../..../
/.//////././/////./
/................./
///////////////////